#.....##
#...#..#
#......#
#......#
#.##...#
#......#
##.....#
##.#...#